NO ./sp/SO.xpm
SO ./sp/NO.xpm
EA ./sp/WE.xpm
F 0,0,255
C 47,174,226
WE ./sp/EA.xpm

1111111111111
1000000000001

100N000000001
1111111111111
