NO ./sp/NO.xpm
SO ./sp/SO.xpm
EA ./sp/EA.xpm
WE ./sp/WE.xpm

F 200,100,0
C 0,0,255

 11111111
 10008001
10N011111
11111
