NO ./sp/NO.xpm
SO ./sp/SO.xpm
EA ./sp/EA.xpm
EW ./sp/NO.xpm

F 200,100,0
C 0,0,255

 11111111
 10000001
10N011111
11111
