WE ./sp/WE.xpm
EA ./sp/EA.xpm
NO ./sp/NO.xpm
SO ./sp/SO.xpm

F 255,255,255
C 47,174,224

1111111111111111111
1111111111111111121
1100000000000000021
1100000000000102021
1100010000000001021
1100010000000001021
1100000000000000011
1101000000000110011
1101A00000000000011
1100000200200000011
1100000000000000011
1100000000000000011
1100000200200000011
1100000000000000011
1100000000001000011
1101011000111000011
1111001000000000011
1110000000000000011
1110001000000000011
1110001000000000011
1110001000000000011
1110001000000000011
1110000000000000011
1110000000002201011
1110010000001001011
1110010000000001011
1110002000000000011
1110022011100001011
1110000000110011111
1111111113110000011
1110000000000001011
1110000000100001011
110000000J100001011
1110000000000000011
1110000000000000011
1110000000000000011
1101110000000000011
1100100000000001011
11000100N0000001011
1202010000000000111
1221111111111111111
1111111111111111111
