WE ./sp/WE.xpm
EA ./sp/EA.xpm
NO ./sp/NO.xpm
SO ./sp/SO.xpm

F 255,255,255
C 47,174,224


1111111111111111
101D100000100021
100E000000000011
1100000000100011
1111111111111111