111111111111111
101D10000010002
100E00000000001
110000000010001
111111111111111