WE ./sp/WE.xpm
EA ./sp/EA.xpm
NO ./sp/NO.xpm
SO ./sp/SO.xpm

F 255,255,255
C 47,174,224

11111111
101D1001
100S0001
10000001
10000001
10100101
10000001
11121111
11111111