11111111
10111001
10010001
10000001
10000001
10100101
10000001
11111111
