11111111
101D1001
100E0001
10000001
10000001
10100101
10000001
11121111