1111111111111111
1000D00010000101
1010N00000000001
1001000000000101
1000100000000101
1111111111111111