1111111111111112
1000000000000002
1000000000010102
1000100000000102
1000100000000102
1000000000000001
1000000000011001
1000000000000001
1000000000000001
1000000000000001
1000000000000001
1000000000000001
1000000000000001
1000000000000001
1000000000000001
1000000000000001
10000D0000000001
1000000000000001
1000000000220101
1000000000200101
1000000000000101
1000000000000001
1000000000000101
1100001010000001
1300000000000001
110D001010000001
1000000000000101
1011N10000000001
1001000000000101
1000100000000101
1111111111111111