NO ./sprites/NO.xpm
SO ./sprites/SO.xpm
WE ./sprites/WE.xpm
EA ./sprites/EA.xpm

F 190,160,100
C 47,174,224

111111111
100000001
100000001
100000001
10000N001
100000001
100001001
100000001
111111111
