C 47,    174,   224


NO ./sprites/NO.xpm

SO            .....     ./sprites/SO.xpm


WE 	                       	./sprites/WE.xpm

EA      ./sprites/EA.xpm


F 255   ,,   ,,255,,,,,255

1111111  1111111111111111
1000001111000000000000001
1000000000000000000000001
1000N00000000000000000001
1000000000000000000000001
1111111111111111111111111

