1111111111111112
1000000000000002
1000000000010202
1000100000000102
1000100000000102
1000000000000001
1010000000011001
101D000000000001
1000002002000001
1000000000000001
1000000000000001
1000002002000001
1000000000000001
1000000000010001
1010110001110001
1110010000000001
1100000000000001
1100000000000001
1100000000220101
1100000000200101
1100000000000101
1100000000000001
1100000000000101
1100001010000001
1300000000000001
110D001010000001
1000000000000101
1011N10000000001
1001000000000101
1000100000000101
1111111111111111