C 47,    174,   224


NO ./sprites/NO.xpm
NO ./sprites/NO.xpm
SO            .....     ./sprites/SO.xpm


WE 	                       	./sprites/WE.xpm

EA      ./sprites/EA.xpm


F 255   ,,   ,,255,,,,,255

1111111111111111111111111
1000000000110000000000001
101100000111000N000000001
100100000000000000000000111111111
111111111011000001110000000000001
100000000011000001110111111111111
11110111111111011100000010001
11110111111111011101010010001
11000000110101011100000010001
10000000000000001100000010001
10000000000000001101010010001
1100000111010101111101111000111
11110111 1110101 101111010001
11111111 1111111 111111111111
