1111111111111
1000000000001
1000000010101
1001000000101
1001000000101
1000000000001
1000000000101
1100101000001
1000000000101
1010000000101
1001000000101
1111111111111
