NO ./sp/NO.xpm
SO ./sp/SO.xpm
EA ./sp/WE.xpm
WE ./sp/EA.xpm
F 255,255,255
C 47,174,226

1111111  111  11111111111
1000001111011111000000001
1000000000000000000000001
1000000000000000000000001
1000000000000000000000001
1000000000000000000000001
1000000000000000000000001
1000000000000000000000001
100000000000000E000000001
1000000000010000000000001
1000000000000000000000001
1000000000000000000000001
1000000000000000000000001
1000000000000000000000001
1111111111111111111111111
