
WE ./sp/WE.xpm
EA ./sp/EA.xpm
NO ./sp/NO.xpm
SO ./sp/SO.xpm

F 255,255,255
C 47,174,224

1111111  111  11111111111
1000001111011111000000001
1000000000000000000000001
1000000000000000000000001
1000000000000000000000001
1000000000000000000000001
1000000000000000000000001
1000000000000000000000001
1000000000000000000000001
1000000000010000000000001
10000000000000N0000000001
1000000000000000000000001
1000000000000000000000001
1000000000000000000000001
1111111111111111111111111
