11111111111111112
10000000000000002
10000000000010202
10001000000000102
10001000000000102
10000000000000001
10100000000011001
101A0000000000001
10000020020000001
10000000000000001
10000000000000001
10000020020000001
10000000000000001
10000000000100001
10101100011100001
11100100000000001
11000000000000001
11000100000000001
11000100000000001
11000100000000001
11000100000000001
11000000000000001
11000000000220101
11001000000100101
11001000000000101
11000200000000001
11002201110000101
11000000011001111
11111111311000001
11000000000000101
11000000010000101
10000000J10000101
11000000000000001
11000000000000001
11000000000000001
10111000000000001
10010000000000101
1000100S000000101
20201000000000011
22111111111111111