
WE ./sprites/WE.xpm
EA ./sprites/EA.xpm
NO ./sprites/../sprites/NO.xpm




C 47,174,224
SO ./sprites/SO.xpm


F 255,255,255

1111111  111  11111111111
1000001111011111000000001
1000000000000000000000001
1000000000000000000000001
1000000000000000000000001
1000000000000000000000001
1000000000000000000000001
1000000000000000000000001
1000000000000000000000001
1000000000010000000000001
10000000000000S0000000001
1000000000000000000000001
100000S000000000000000001
1000000000000000000000001
1111111111111111111111111
