C 47,    174,   224


NO ./sprites/NO.xpm
SO            .....     ./sprites/SO.xpm


F 255   ,,   ,,0,,,,,125



WE 	                       	./sprites/WE.xpm

EA      ./sprites/EA.xpm


1111111111
1000000001
1100000001
10000N0001
1000000001
1111111111
