NO ./sprites/NO.xpm
SO ./sprites/SO.xpm
WE ./sprites/WE.xpm
EA ./sprites/EA.xpm

F 220,100,0
C 190,160,100

1111111111111
1000000000001
10E0000010101
1001000000101
1001000000101
1000000000001
1000000000101
1100101000001
1000000000101
1010000000101
1001000000101
1111111111111
