NO ./sprites/NO.xpm
SO            ...     ./sprites/SO.xpm

WE  ./sprites/WE.xpm

EA      ./sprites/EA.xpm

F 255   ,,   ,,255,,,,,                     255



C 47,    174,   224

1111111111
1000000001
1100000001
10000W0001
1111111111
