1111111111111
1000000000001
1000000000001
1000000000001
1000000000001
1000000000001
1011010000001
1001000000001
1000000000001
1111111111111