1111111111111111
1000000000000001
1000000000000101
1000100000000101
1000100000000101
1000000000000001
1000000000000001
1000000000000001
1000000000000001
1000000000000001
1000000000000001
1000000000000001
1000000000000001
1000000000000001
1000000000000001
1000000000000001
1000000000000001
1000000000000001
1000000000110101
1000000000100101
1000000000000101
1000000000000001
1000000000000101
1000001010000001
1000000000000001
1000001010000001
1000000000000101
1011N10000000001
1001000000000101
1000100000000101
1111111111111111